%%%%%%%%
%PG  G %
% .% . %
%  %   %
% .% . %
% G    %
%%%%%%%%
