%%%%%%%%
%P   . %
% .%   %
%  .   %
%G  %. %
%%... G%
%%%%%%%%
