%%%%%%%%
%P   . %
% .%   %
%  .   %
%  % . %
%%    G%
%%%%%%%%
